Second Level
10 x 20
2 10
XXXXXXXXXXXXXXXXXXXX
X                  X
X              A   X
X                  X
        XXXX
X                  X
X   @              X
X                  X
X                  X
XXXXXXXXXXXXXXXXXXXX