First Level
20 x 20
4 1
XXXXXXXXX XXXXXXXXXX
X                  X
X                  X
X   A              X
X        X         X
X        X         X
X        X         X
X                  X
X                  X
     XXXXXXXXX
X                  X
X                  X
X              @   X
X        X         X
X   A    X         X
X        X         X
X                  X
X                  X
X                  X
XXXXXXXXX XXXXXXXXXX
